20
20
9
9
11111111111111101111
10101010101010101011
10000010001000101001
10111000100010000011
10111111111111111011
10000000000000001011
10101010111110101011
10001111000100111111
11011110010101010101
10001000100101000001
11101001110100011101
10101011100110010001
10001011110110011101
11010011100100100111
10010000110010100001
10111110100000110100
10011000001010111101
10100010101010001001
10001010101010101011
11111111111111111111
